; hello world
#####E#####
#K#_#_#####
#_#_#_#_#_#
#_____#_#_#
#####S__#_#
#M____###_#
#####_____#
###########