####_####
#_##_#_#_
_____#_#_
####___#_
_____###_
####_____