; hello world
#####-#####
#..T#.#.#B#
#.###.#.#.#
#.F...#.S.#
#.#.###.#.#
#.#..G..#.#
#.#####.###
#.#Z..#...#
#.###.###.#
#..D#..C..#
###########