; hello world
#####-#####
#___#_#_#!#
#_###_#_#_#
#_F___#___#
#_#_###_#_#
#_#__G__#_#
#_#####_###
#_#X__#___#
#_###_###_#
#___#__C__#
###########