; hello world
###########
#___#_#_#!#
#_###_#-#_#
#_F___#_X_#
#_#_###_#_#
#_#__G__#_#
#_#####_###
#_#___#___#
#_###_###_#
#___#__C__#
###########